1111111111111111111111111111111111111111111111111111111111111111
1000000000000000000001000000000000000000000000000000000000000001
1000000000000000000001001110000000000000000000000000000000000001
1011111111111111110001001110000000000000000000000000000000000001
100000000000E000E00001001111111100000000000000000000000000000001
1000000000000000000001001000000110000000000000000000000000000001
1000000111111111111111001000000010000000000000000000000000000001
1000E00100000000000000001000000010000000000000000000000000000001
1000000100000000000000001111000011000000000000000000000000000001
1000000111111111111000000001000001100000000000000000000000000001
1001000000000000001000000001000000100000000000000000000000000001
1011110E00000000001001110001000000100000000000000000000000000001
1010010000001111111011011001100000100000000000000000000000000001
1E11010011111000000010001000110000100000000000000000000000000001
1011010010000000000010001100011000100000000000000000000000000001
1E10010010000000000011000100001000110000000000000000000000000001
1010010010001111110001000100001100011000000000000000000000000001
1010110010011000010011000111000100001000000000000000000000000001
1010100010010000010010000001100110001000000000000000000000000001
1010111110010000010010000000110010001000000000000000000000000001
1010000000010000011010000000010000001000000000000000000000000001
1011111111110000001011000000010010001000000000000000000000000001
1000000000000000001001110000100010001000000000000000000000000001
1E0E001111011111001000010000100010011000000000000000000000000001
100E001001110001001111111000100010010000000000000000000000000001
1000011000000001000000000001100010110000000000000000000000000001
1000010000000001100000000001100110100000000000000000000000000001
1000010000000000111111111111001100100000000000000000000000000001
1000010000000000000000000000001000100000000000000000000000000001
1000010000000000000000000000011000100000000000000000000000000001
1000010000000000011111110001110000100000000000000000000000000001
1000010000000000110000011011000001100000000000000000000000000001
1000010011100001100000011010000001000000000000000000000000000001
1000010110111001000000010010000011000000000000000000000000000001
10E0010100001001000000110011000010000000000000000000000000000001
1000010100001001000001100001000110000000000000000000000000000001
1000010100001001000011000001000100000000000000000000000000000001
100E010110001001000110000011001100000000000000000000000000000001
1000010110001001001100000110011000000000000100000000000000000001
1000011100001001011000011100001000001111111100000000000000000001
1000011000001001011000110000001000001000001100000000000000000001
100000000000100100110010000E001100001000001000000000000000000001
100000000000100100010011000E000100011000001000000000000000000001
1001100000001001000110010000000110110000001000000000000000000001
1001110000001001000010011000000101100000001000000000000000000001
1001011100011001000010001000000111000000011000000000000000000001
10010001111100010000100010000E00000000000100000011111000000E0001
10010000000000010000110011000000000000E00100000110001100000E0001
10010000000000010000110001100000000000001100000100000100000E0001
1001000000000011000110000010000000000001100000110000011000000001
100110000000111000110000001100E000000011000000100000001000000001
10E011100001100001100000000110E000000010000000110000001000000001
10000011111100001100011100001100000E0110000000011100011000000001
100E000000000111100011011000011000000111000000000000110000000001
100000001111110000011000100000100EE00001111000000011100000000001
1000001110000000000100011000001100E00000001111111110000000000001
10000110000000000001100100000001000000000000000000000E0000000001
10001100000011110000110110000001000000000000000000000E0000000001
1000100000001001000011001100001100000000E00000000000EE0000000001
10E01100000110011011100E0111111000E00000E00000000E00000000000001
100001111111000011100000000000000EE00000000000000000000000000001
1000000000000E00000000000000000000000000000000000000000000000001
10000000000000000000E0000000E00000000000000000000000000000000001
1111111111111111111111111111111111111111111111111111111111111111
