1111111111111111111111111111111111111111111111111111111111111111
1000000000000000000000000000000000000000000000000000000000000001
1000000000000000000000000000000000000000000000000000000000000001
1000011111100000000000000000000000000000000000000000001111100001
1000010000100000000000000000000000000000000000000000001000100001
1000010000100000000000000000000000000000000000000000001000100001
1000011111100000000000000000000000000000000000000000001111100001
1000000000000000000000000000000000000000000000000000000000000001
1000000000000000000000000000000000000000000000000000000000000001
1000000000000001111111111100000000001111111111000000000000000001
1000000000000001000000000100000000001000000000100000000000000001
1000000000000001000000000100000000001000000000100000000000000001
1000000000000001000000000000000000000000000000100000000000000001
1000000000000001000000000000000000000000000000100000000000000001
1000000000000001000000000100000000001000000000100000000000000001
1000000000000001111111111100000000001111111111100000000000000001
1000000000000000000000000000000000000000000000000000000000000001
1000000000000000000000000000000000000000000000000000000000000001
1000000000000000000000000000000000000000000000000000000000000001
1000000000000000000011100000000000000001110000000000000000000001
1000000000000000000010100000000000000001010000000000000000000001
1000000000000000000010100000000000000001010000000000000000000001
1000000000000000000011100000000000000001110000000000000000000001
1000000000000000000000000000000000000000000000000000000000000001
1000000000000000000000000000000000000000000000000000000000000001
1000000000000000000000000000111111000000000000000000000000000001
1000000000000000000000000000100001000000000000000000000000000001
1000000000000000000000000000100001000000000000000000000000000001
1000000000000000000000000000100001000000000000000000000000000001
1000000000000000000000000000100001000000000000000000000000000001
1000000000000000000000000000100001000000000000000000000000000001
1000000000000000000000000000111111000000000000000000000000000001
1000000000000000000000000000000000000000000000000000000000000001
1000000000000000000000000000000000000000000000000000000000000001
1000001111110000000000000000000000000000000000000011111100000001
1000001000010000000000000000000000000000000000000010000100000001
1000001000010000000000000000000000000000000000000010000100000001
1000001000010000000000000000000000000000000000000010000100000001
1000001111110000000000000000000000000000000000000011111100000001
1000000000000000000000000000000000000000000000000000000000000001
1000000000000000000000000000000000000000000000000000000000000001
1000000000000000001111111111111111111111110000000000000000000001
1000000000000000001000000000000000000000010000000000000000000001
1000000000000000001000000000000000000000010000000000000000000001
1000000000000000001000000000000000000000010000000000000000000001
1000000000000000000000000000000000000000000000000000000000000001
1000000000000000000000000000000000000000010000000000000000000001
1000000000000000001000000000000000000000010000000000000000000001
1000000000000000001000000000000000000000010000000000000000000001
1000000000000000001111111111111111111111110000000000000000000001
1000000000000000000000000000000000000000000000000000000000000001
1000000000000000000000000000000000000000000000000000000000000001
1000000000000000000000000000000000000000000000000000000000000001
1000001110000000000000000000000000000000000000000000011100000001
1000001010000000000000000000000000000000000000000000010100000001
1000001110000000000000000000000000000000000000000000011100000001
1000000000000000000000000000000000000000000000000000000000000001
1000000000000000000000000000000000000000000000000000000000000001
1000000000000000000000000000000000000000000000000000000000000001
1000000000000000000000000000000000000000000000000000000000000001
1000000000000000000000000000000000000000000000000000000000000001
1000000000000000000000000000000000000000000000000000000000000001
1000000000000000000000000000000000000000000000000000000000000001
1111111111111111111111111111111111111111111111111111111111111111
