1111111111111111111111111111111111111111111111111111111111111111
10000000000000000000GGGGGGGGGGGGG0000000000000000000000000000001
100770000000000000GGG0000000000000000000000000000000000000000001
10000111111008H0000007777000000000000000000000000000001111100001
1000010000008800000777007770000000000000000000000000001000100001
1060000000188001177700000077700000000000000000000000001000100001
1660010111180L01770000000000700000000000000000000000001111100001
1600000000000017700000000000700000000000000000000000000000000001
100T000440000177000000000007700000000000000000000000000000000001
1000000040A00770000011111777000000001111111111000000000000000001
1050080040007701000000077700000000001000000000100000000000000001
1055580000007101000007770100000000001000000000100000000000000001
1000080000077001000777000000000000000000000000100000000000000001
10L0080000771001777000000000000000000000000000100000000000000001
1000080000700007700000000100000000001000000000100000000000000001
1000080007700001000111111100000000001111111111100000000000000001
1000080007000000080000000000000000000000000000000000000000000001
1000000000000000088000000000000000000000000000000000000000000001
1000G00000000000008800000000000000000000000000000000000040000001
10000000K0000000000811100000000000000001110000000000000040000001
10R00000KKK00000000810100000000000000001010000000000000040000001
10R0000B00KKKKK0000010100000000000000001010000000000000040000001
10R0000000000000000011100000000000000001110000000000000040000001
10RR000000000000000000000000000000000000000000000000000040000001
100RRRR000000000000000000000000000000000000000000000000040000001
1000000000000000000000000000111111000000000000000110000045000001
1000000000000110000000000000100001000000000000001100000045000001
1000000111111100000000000000100001000000000000011000000045000001
10R0001100000000000000000000100001000000000001110500000005000001
100000000000000000KKKKKK0000100001000000001111005500050055000001
10000000000KKKKKKKK000000000100001000000111000055000550050000001
100C000000KK0000000000000000111111000011100000550005500550000001
1000000000000000000000000000000000011110000005500555000500000001
1000000000000000000000000000000011110000000055005500000500000001
1000001111110000000000000000000110000000000550555011115500000001
10K0001000010000000000000000000000000000005505500010000100000001
1000001000010000000000000000000000000000000555000010000100000001
1000001000010000000000000000000000000000000000000010000100000001
1000001111110000000000000000000000000000000000000011111100000001
100A000000000000000000000000000000000000000000000000000000000001
1000000000000000000000000000000000000000000000000000000000000001
1000000000000000001111111111111111111111110000000000000000000001
100000H000000000001000000000000000000000010000000000000000000001
1000000000000000001000000000000000000000010000000000000000000001
1000000000T00000001000000000000000000000010000000000000000000001
1000000000000000000000000000000000000000000000000000000000000001
1000000000000000000000000000000000000000010000000000000000000001
1000000000000000001000000000000000000000010000000000000000000001
1000000000000000001000000000000000000000010000000000000000000001
1000000000000000001111111111111111111111110000000000000000000001
1000000000000000000000000000000000000000000000000000000000000001
1000000000000000000000000000000000000000000000000000000000000001
1000000000000000000000000000000000000000000000000000000000000001
1000001110000000000000000000000000000000000000000000011100000001
1000001010000000000000000000000000000000000000000000010100000001
1000001110000000000000000000000000000000000000000000011100000001
1000000000000000000000000000000000000000000000000000000000000001
1000000000000000000000000000000000000000000000000000000000000001
1000000000000000000000000000000000000000000000000000000000000001
1000000000000000000000000000000000000000000000000000000000000001
1000000000000000000000000000000000000000000000000000000000000001
1000000000000000000000000000000000000000000000000000000000000001
1000000000000000000000000000000000000000000000000000000000000001
1111111111111111111111111111111111111111111111111111111111111111
