1111111111111111111111111111111111111111111111111111111111111111
1000000000000000000000000000000000000000000000000000000000000001
1000000000000000000000000000000000000000000000000000000000000001
1000000000000000000000L00000000C000A0000000000000000000000000001
10001111111111110000LLL0000000CC000AAAAAA00000000000000000000001
1000000000000000000LL00000000CC000000000000L00000000000000000001
1001000000000000LLL0000CCCCCC0000000000000LL00K00000000000000001
100110000000000LL000000000000000000000H000L000K00000000000000001
10001000000000000000000000000000000000H000L000K00000000000000001
1000110099000000000000000000TTTTTTTT00H000L000K00000000000000001
1000010000000000000000TTTTTTT000000000H0000000K00000000000000001
100001000000000000TTTTT0000LL000000000H000000KK00000000000000001
1000010002000000000000000000LL0000000H000000KK000000000000000001
10000100022000000000000000000LLL00000H00K0KKK0000000000000000001
1000010000200000000000B00000000LLL000H00KKK000000000000000000001
1000010000200990000000BBBB0000000LL00H00000000000000000000000001
100001000020000000EEE0000BBBBB0000000H00000000000000000000000001
10000000002000030000EEEE0000000000000H00000000000000000000000001
10000000002000033000000EEEEEEEEEEE000H00000000000000000000000001
1000AAAAAA200000300000000000000000000H00000000000000000000000001
1000A00000220000300000000000000000000H00000000000000000000000001
1000000000020000330000000000000000000000000000000000000000000001
1000000000020000030000000000000000000000000000000000000000000001
1000000000020000030000000000000000000000000000000000000000000001
1000000000000000030099000000000000000000000000000000000000000001
1000000000000000030000000000000000000000000000000000000000000001
1000000000000000030000440000000000000000000000000000000000000001
1000000000000000030000040000000000000000000000000000000000000001
1000000000000000030000044009900000011110000000000000000000000001
1000000000000000030000004000000000000011100000000000000000000001
1000000000000000030000004000005000000000000000000000000000000001
1000000000000000033000004400005000000000000000000000000000000001
1000000000000000003000000400005509900000000000000000000000000001
1000000000000000000000000400000500000000000000000000000000000001
1000000000000000000000000400000500000000000000000000000000000001
1000000000000000000000000400000500060000000000000000000000000001
1000000000000000000000000400000500060099000000000000000000000001
1000000000000000000000000400000500066000000000000000000000000001
1000000000000000000000000400000500006000070000000000000000000001
1000000000000000000000000400000500006000070000000000000000000001
1000000000000000000000000000000500006000070099000000000000000001
1000000000000000000000000000000500006600070000880000000000000001
1000000000000000000000000000000500000600077000080000000000000001
1000000000000000000000000000000000000600007000080000000000000001
1000000000000000000000000000000000000600007000080000000000000001
1000000000000000000000000000000000000600007000080009000000000001
1000000000000000000000000000000000000000007000080009000000000001
1000000000000000000000000000000000000000007000080009000000000001
1000000000000000000000000000000000000000000000080009000000000001
1000000000000000000000000000000000000000000000080009900000000001
1000000000000000000000000000000000000000000000000000900000000001
1000000000000000000000000000000000000000000000000000900000000001
1000000000000000000000000000000000000000000000000000900000000001
1000000000000000000000000000000000000000000000000000900000000001
1000000000000000000000000000000000000000000000000000900000000001
1000000000000000000000000000000000000000000000000000000000000001
1000000000000000000000000000000000000000000000000000000000000001
1000000000000000000000000000000000000000000000000000000000000001
1000000000000000000000000000000000000000000000000000000000000001
1000000000000000000000000000000000000000000000000000000000000001
1000000000000000000000000000000000000000000000000000000000000001
1000000000000000000000000000000000000000000000000000000000000001
1000000000000000000000000000000000000000000000000000000000000001
1111111111111111111111111111111111111111111111111111111111111111
