11111111111111111111111111111111111111111111111111111111111111111111111111111111111111111111111111111111111111111111111111111111
10000000000000000000000000000000000000000000000000000000000000000000000000000000000000000000000000000000000000000000000000000001
10000000000000000000000000000000000000000000000000000000000000000000000000000000000000000000000000000000000000000000000000000001
10000111111000000000000000000000000000000000000000000011111000000000000000000000000000000000000000000000000000000000000000010001
10000100001000000000000000000000000000000000000000000010001000000000000000000000000000000000000000000000000000000000000000001001
10000100001000000000000000000000000000000000000000000010001000000000000000000000000000000000000000000000000000000000000000000001
10000111111000000000000000000000000000000000000000000011111000000000000000000000000000000000000000000000000000000000000000000001
10000000000000000000000000000000000000000000000000000000000000000000000000000000000000000000000000000000000000000000000000000001
10000000000000000000000000000000000000000000000000000000000000000000000000000000000000000000000000000000000000000000000000000001
10000000000000011111111111000000000011111111110000000000000000000000000000000000000000000000000000000000000000000000000000000001
10000000000000010000000001000000000010000000001000000000000000000000000000000000000000000000000000000000000000000000000000000001
10000000000000010000000001000000000010000000001000000000000000000000000000000000000000000000000000000000000000000000000000000001
10000000000000010000000000000000000000000000001000000000000000000000000000000000000000000000000000000000000000000000000000000001
10000000000000010000000000000000000000000000001000000000000000000000000000000000000000000000000000000000000000000000000000000001
10000000000000010000000001000000000010000000001000000000000000000000000000000000000000000000000000000000000000000000000000000001
10000000000000011111111111000000000011111111111000000000000000000000000000000000000000000000000000000000000000000000000000000001
10000000000000000000000000000000000000000000000000000000000000000000000000000000000100000000000000000000000000000000000000000001
10000000000000000000000000000000000000000000000000000000000000000000000000000000000100000000000000000000000000000000000000000001
10000000000000000000000000000000000000000000000000000000000000000000000000000000001100000000000000000000000000000000000000000001
10000000000000000000111000000000000000011100000000000000000000000000000000000000001100000000000000000000000000000000000000000001
10000000000000000000101000000000000000010100000000000000000000000000000000000000001100000000000000000000000000000000000000000001
10000000000000000000101000000000000000010100000000000000000000000000000000000000001100000000000000000000000000000000000000000001
10000000000000000000111000000000000000011100000000000000000000000000000000000000001100000000000000000000000000000000000000000001
10000000000000000000000000000000000000000000000000000000000000000000000000000000001010000000000000000000000000000000000000000001
10000000000000000000000000000000000000000000000000000000000000000000000000000000001001000000000000000000000000000000000000000001
10000000000000000000000000001111110000000000000000000000000000000000000000000000000001000000000000000000000000000000000000000001
10000000000000000000000000001000010000000000000000000000000000000000000000000000000001000000000000000000000000000000000000000001
10000000000000000000000000001000010000000000000000000000000000000000000000000000000001000000000000000000000000000000000000000001
10000000000000000000000000001000010000000000000000000000000000000000000000000000000001000000000000000000000000000000000000000001
10000000000000000000000000001000010000000000000000000000000000000000000000000000000010000000000000011000000000000000000000000001
10000000000000000000000000001000010000000000000000000000000000000000000000000000000010000000000000101000000000000000000000000001
10000000000000000000000000001111110000000000000000000000000000000000000000000000000001000000000011001000000000000000000000000001
10000000000000000000000000000000000000000000000000000000000000000000000000000000000001000000000010000100000000001000000000000001
10000000000000000000000000000000000000000000000000000000000000000000000000000000000010000000000010000100000000000100000000000001
10000011111100000000000000000000000000000000000000111111000000000000000000000000000100000000000010000100000000000100000000000001
10000010000100000000000000000000000000000000000000100001000000000000000000000000001000000000000010000010000000001000000000000001
10000010000100000000000000000000000000000000000000100001000000000000000000000000110000000000000001000010000000001000000000000001
10000010000100000000000000000000000000000000000000100001000000000100000000000011000000000000000001000010000000010000000000000001
10000011111100000000000000000000000000000000000000111111000000000110000000000100000000000000000001000010000000100000000000000001
10000000000000000000000000000000000000000000000000000000000000000001000000000000000000000000000001000001000001000000000000000001
10000000000000000000000000000000000000000000000000000000000000000000100000000000000000000000000001000000100010000000000000000001
10000000000000000011111111111111111111111100000000000000000000000000010000000000000000000000000000100000111100000000000000000001
10000000000000000010000000000000000000000100000000000000000000000000001000000000000000000000000000100000000000000000000000000001
10000000000000000010000000000000000000000100000000000000000000000000000100000000000000000000000000100000000000000000000000000001
10000000000000000010000000000000000000000100000000000000000000000000000010000000000000000000000000100000000000000000000000000001
10000000000000000000000000000000000000000000000000000000000000000000000010000000000000000000000000100000000000000000000000000001
10000000000000000000000000000000000000000100000000000000000000000000000010000000000000000000000000010000000000000000000000000001
10000000000000000010000000000000000000000100000000000000000000000000000100000000000000000000000000010000000000000000000000000001
10000000000000000010000000000000000000000100000000000000000000000000000100000000000000000000000000010000000000000000000000000001
10000000000000000011111111111111111111111100000000000000000000000000000010000000000000000000000000010000000000000000000000000001
10000000000000000000000000000000000000000000000000000000000000000000000001110000000000000000000000010000000000000000000000000001
10000000000000000000000000000000000000000000000000000000000000000000000000001000000000000000000000010000000000000000000000000001
10000000000000000000000000000000000000000000000000000000000000000000000000000100000000000000000000010000000000000000000000000001
10000011100000000000000000000000000000000000000000000111000000000000000000000100000000000000000000010000000000000000000000000001
10000010100000000000000000000000000000000000000000000101000000000000000000000100000000000000000000010000000000000000000000000001
10000011100000000000000000000000000000000000000000000111000000000000000000000010000000000000000000010000000000000000000000000001
10000000000000000000000000000000000000000000000000000000000000000000000000000001000000000000000000010000000000000000000000000001
10000000000000000000000000000000000000000000000000000000000000000000000000000000110000000000000000010000000000000000000000000001
10000000000000000000000000000000000000000000000000000000000000000000000000000000001000000000000000010000000000000000000000000001
10000000000000000000000000000000000000000000000000000000000000000000000000000000000110000000000000010000000000000000000000000001
10000000000000000000000000000000000000000000000000000000000000000000000000000000000000000000000000010000000000000100000000000001
10000000000000000000000000000000000000000000000000000000000000000000000000011100000000000000000000010000000000001100000000000001
10000000000000000000000000000000000000000000000000000000000000000000000000010000000000000000000000010000000000001000000000000001
10000000000000000000000000000000000000000000000000000000000000000000000000010000000000000000000000010000000000001000000000000001
10000000000000000000000000000000000000000000000000000000000000000000000000100000000000000000000000001000000000000100000000000001
10000000000000000000000000000000000000000000000000000000000000000000000000100000000000000000000000010000000000000100000000000001
10000000000000000000000000000000000000000000000000000000000000000000000000100000000000000000000000010000000000000100000000000001
10100000000000000000000000000000000000000000000000000000000000000000000001000000000000000000000000100000000000000100000000000001
10100000000000000000000000000000000000000000000000000000000000000000000001000000000000000000000000100000000000000100000000000001
10100000000000000000000000000000000000000000000000000000000000000000000011000000000000000000000001000000000000000100000000000001
10010000000000000000000000000000000000000000000000000000000000000000000110000000000000000000000000000000000000000100000000000001
10010000000000000000000000000000000000000000000000000000000000000000001100000000000000000000000000000000000000000100000000000001
10011000000000000000000000000000000000000000000000000000000000000000011000000000000000000000000000000000000000011100000000000001
10001000000000000000000000000000000000000000000000000000000000000000100000000000000000000000000000000000000000010000000000000001
10001000000000000000000000000000000000000000000000000000000000000001100000000000000000000000000000000000000000010000000000000001
10001000000000000000000000000000000000000000000000000000000000000001000000000000000000000000000000000000000000010000000000000001
10001000000000000000000000000000000000000000000000000000000000000000000000000000000000000000000000000000000000010000000000000001
10001000000000000000000000000000000000000000000000000000000000000000000000000000000000000000000000000000000000010000000000000001
10001000000000000000000000000000000000000000000000000000000000000000000000000000000000000000000000000000000000001000000000000001
10001000000000000000000000000000001111111000000000000000000000000000000000000000000000000000000000000000000000001000000000000001
10001100000000000000000000000000011000000100000000000000000000000000000000000000000000000000000000000000000000001000000000000001
10000100000000000000000000000000110000000010000000000000000000000000000000000000000000000000000000000000000000001000000000000001
10000100000000000000000000000000100000000001100000000000000000000000000000000000000000000000000000000000000000001000000000000001
10000010000000000000000000000001000000000000100000000000000000000000000000000000000000000000000000000000000000001000000000000001
10000010000000000000000000000001000000000000000000000000000000000000000000000000000001000000000000000000000000001000000000000001
10000010000000000000000000000010000000000000000000000000000000000000000000000000000001000000000000000000000000001000000000000001
10000011000000000000000000000100000000000000000000000000000000000000000000000000000001000000000000000000000000001000000000000001
10000001000000000000000000000100000000000000000000000000000000000000000000000000000001000000000000000000000000001000000000000001
10000001000000000000000000000100000000000000000000000000000010000000000000000000000000100000000000000000000000000000000000000001
10000001000000000000000000000000000000000000000000000000000010000000000000000000000000100000000000000000000000000000000000000001
10000000100000000000000000000000000000000000000000000000001100000000000000000000000000100000000000000000000000000000000000000001
10000000100000000000000000000000000000000000000000000000011000000000000000000000000000010000000000000000000000000000000000000001
10000000110000000000000000000000000000000000000000000000110000000000000000000000000000010000000000000000000011000000000000000001
10000000010000000000000000000000000000000000001110000011100000000000000000000000000000010000000000000000000001000000000000000001
10000000011000000000000000000000000000000000000011111110000000000000000000000000000000001000000000000000000000111000000000000001
10000000001000000000000000000000000000000000000000000000000000000000000000000000000000000100000000000000000000001100000000000001
10000000000100000000000000000000000000000000000000000000000000000000000000000000000000000010000000000000000000000110000000000001
10000000000110000000000000000000000000000000000000000000000000000000000000000000000000000001000000000000000000000001000000000001
10000000000010000000000000000000000000000000000000000000000000000000000000000000000000000000100000000000000000000000100000000001
10000000000001000000000000000000000000000000000000000000000000000000000000000000000000000000100000000000000000000001000000000001
10000000000001000000000000000000000000000000000000000000000000000000000000000000000000000000100000000000000000000001000000000001
10000000000000100000000001000000000000000000000000000000000000000000000000000000000000000000100000000000000000000000100000000001
10000000000000100000000000111100000000000000000000000000000000000000000000000000000000000000100000000000000000000000110000000001
10000000000000110000000000000011000000000000000000000000000000000000000000000000000000000000011000000000000000000000010000000001
10000000000000011000000000000000000000000000000000000000000000000000000000000000000000000000000100000000000000000000001000000001
10000000000000001000000000000000000000000000000000000000000000001110000000000000000000000000000011000000000000000000001000000001
10000000000000000100000000000000000000000000000000000000000000001000000000000000000000000000000000110000000000000000000000000001
10000000000000000010000001000000000000000000000000000000000000001100000000000000000000000000000000001100000000000000000000000001
10000000000000000001100001100000000000000000000000000000000000000100000000010000000000000000000000000011000000000000000000000001
10000000000000000000110000110000000000000000000000000000000000000011100001110000000000000000000000000000000000000000000000000001
10000000000000000000011110010000000000000000000000000000000000000000011111001000000000000000000000000000000000000000000000000001
10000000000000000000000011110000000000000000011100000000000000000000000000000110000000000000000000000000000000000000000000000001
10000000000000000000000000000000000000000000010110000000000000000000000000000011000000000000000000000000000000000000000000000001
10000000000000000000000000000000000000000000010011000000000000000000000000000000000000000000000000000000000000000000000000000001
10000000000000000000000000000000000000000000010001000000000000000000000000000000000000000000000000000000000000000000000000000001
10000000000000000000000000000000000000000000010001100000000000000000000000000000000000000000000000000000000001100000000000000001
10000000000000000000000000000000000011111111110000100000000000000000000000000000000000000000000000000000000010110000000000000001
10000000000000000000000000000000000000000000000000011000000000000000000000000000000000000000000000000000001100010000000000000001
10000000000011100000000000000000000000000000000000001100000000000000000000000000000000000000001111111100010000001000000000000001
10000000011100110000000000000000000000000000000000000110000000000000000000000000000000000000010000000011100000000100000000000001
10000000100000010000000000000000000000000000000000000011000000000000000000000000000000000000010000000000000000000110000000000001
10000000000000001000000000000000000000000000000000000000111100000000000000000000000000000000000000000000000000000010000000000001
10000000000000001100000000000000000000000000000000000000000011110000000000000000000000000000000000000000000000000010000000000001
10000000000000000111000000000000000000000000000000000000000000001110000000000000000000000000000000000000000000000011100000000001
10000000000000000000000000000000000000000000000000000000000000000010000000000000000000000000000000000000000000000001100000000001
10000000000000000000000000000000000000000000000000000000000000000000000000000000000000000000000000000000000000000000000000000001
10000000000000000000000000000000000000000000000000000000000000000000000000000000000000000000000000000000000000000000000000000001
11111111111111111111111111111111111111111111111111111111111111111111111111111111111111111111111111111111111111111111111111111111
